13 11 3 0 17 8 300
1 1 10 5 3 1 
4 0 0 8 0 0 0 0 0 0 0 0 0 0 0 0 0 0 0 0 0 4 4 4 
4 0 3 3 3 3 3 3 3 3 3 3 3 3 3 3 3 3 3 3 0 4 0 4 
4 0 4 0 0 0 0 0 0 0 0 0 0 0 0 0 0 0 0 0 0 4 0 4 
4 0 4 4 4 4 4 3 3 3 3 3 3 3 3 4 0 0 0 4 4 4 0 4 
4 0 0 0 0 0 0 0 0 0 0 3 3 3 3 4 0 0 0 0 0 0 0 4 
4 0 0 0 0 0 0 0 0 0 0 3 3 3 3 4 3 0 0 0 0 0 0 4 
4 0 0 0 0 0 0 0 0 0 3 3 3 3 3 4 0 0 0 0 0 0 0 4 
4 3 3 3 3 0 0 0 0 3 3 3 3 3 3 4 0 4 0 0 0 0 0 4 
4 3 4 3 3 3 0 0 0 3 3 3 3 3 3 4 0 9 0 0 0 0 0 4 
4 3 3 3 4 4 3 0 3 3 3 3 3 4 4 4 0 3 4 0 0 0 0 4 
4 4 3 3 3 4 3 3 0 0 3 3 3 3 3 3 3 3 4 0 0 0 0 4 
4 3 4 4 3 3 4 3 0 0 0 3 3 3 0 3 3 3 4 4 4 4 0 4 
4 4 3 4 3 3 3 3 0 0 0 3 3 3 0 3 3 4 4 0 0 0 0 4 
4 3 4 4 3 4 3 4 4 4 3 4 4 4 3 4 4 4 4 3 4 3 4 4 
4 4 4 3 4 4 3 4 3 4 3 4 3 4 4 3 3 4 4 4 3 4 3 4 
4 4 4 4 4 4 4 4 4 4 4 4 4 4 4 4 4 4 4 4 4 4 4 4