15 5 0 13 22 6 200
1 1 9 1 3 0 
3 3 3 3 3 3 3 3 3 3 3 3 3 3 3 3 4 3 3 3 3 3 3 3 
3 3 3 3 3 3 3 3 3 3 3 3 3 3 3 3 3 3 3 3 3 3 3 4 
3 3 3 3 3 4 4 4 3 3 3 3 3 3 3 3 3 3 3 3 3 3 3 4 
3 3 3 3 3 3 3 3 3 3 3 4 3 3 3 3 3 0 0 0 3 3 3 4 
3 3 3 3 3 3 3 3 3 3 3 4 4 3 3 3 0 0 0 0 0 0 3 3 
3 3 4 3 3 3 3 3 3 3 3 4 4 4 3 3 3 0 0 0 0 0 0 0 
3 3 3 3 3 3 3 3 3 3 3 4 4 4 3 0 0 0 0 0 0 0 9 0 
3 3 3 3 3 3 3 3 3 3 4 4 4 4 4 0 0 3 3 3 3 0 3 3 
0 0 0 0 0 0 0 3 3 4 4 4 4 4 4 0 0 3 3 0 0 0 3 3 
0 0 0 0 0 0 0 0 0 4 4 4 4 4 0 0 0 3 0 0 0 3 3 3 
0 0 0 0 0 0 0 0 0 0 0 4 4 0 0 0 0 3 0 0 0 3 3 3 
0 0 0 0 0 0 3 3 3 0 0 3 4 0 0 3 3 3 0 0 3 4 4 4 
0 0 0 0 0 0 4 4 4 4 3 3 0 0 0 3 3 3 0 0 3 4 4 4 
8 0 0 0 0 0 3 3 3 3 3 3 4 3 3 3 3 3 3 3 4 4 4 4 
4 4 4 4 4 4 4 4 4 4 4 4 4 4 4 4 4 4 4 4 4 4 4 4 
4 4 4 4 4 4 4 4 4 4 4 4 4 4 4 4 4 4 4 4 4 4 4 4 